NO ./assets/NORD.xpm
SO ./assets/SUD.xpm
WE ./assets/WEST.xpm
EA ./assets/EST.xpm

F 44,62,80
C 52,152,219

111111111111111111111111111111
100010000010100010000000000001
111011111010101110000000000001
101010100000100010000111110001
101010101010101110000000010001
100010001010001010000000010001
101110111110111010000000000001
100000000010000010000110000001
101111111110111110000000000001
100000001000100010000000011111
101110101011111000000000000001
100010101000000000000000N11111
111111111111111110000000000001
100000001000000000000000000001
100000001000000000000001000001
100000000000000000000000000001
100000001000000000000000000001
100000000000000000000001000001
100000000000000000000000000001
100000000000000000000000000001
111111111111111111111111111111
