

NO ./test.xpm

SO ./test.xpm
WE ./test.xpm

EA ./test.xpm


F 222,112,111
C 44,44,55








11111111111111111111
10000000000000000001
10000000000000000001
10000011111111000001
10000011N00011000000
10000011000001100001
10000011000011000001
10000011111111000001
10000000000000000001
11111111111111111111
