

NO ./test.xpm

SO ./test.xpm
WE ./test.xpm

EA ./test.xpm


F 33,112,55
C 44,44,55





0
0
 1111111111111111111111
 1000001              1
 1000001        1     1
 1000001        1 11111
 10N1000   1      1
 1000001          1
 1111101          1
     101          1
     11111111111111
