

NO ./test.xpm

SO ./test.xpm
WE ./test.xpm

EA ./test.xpm


F 222,112,111
C 44,44,55




11111111111111111111
10000000000000000001
1000N000000000000001
10000000000000000001
10000000000000000001
10000000000000000001
10000011110011000001
10000011000000000001
10000011000011000001
10000011111111001001
10000000000000000001
11111111111111111111

