

NO ./assets/NORD.xpm

SO ./assets/SUD.xpm
WE ./assets/WEST.xpm

EA ./assets/EST.xpm


F 44,44,55
C 12,88,222




111111111111111111111111111
100000000000000000000000001
100000000000000000000000001
100000000000000000000000001
100000000000000000000000001
100000000000000000000000001
100000000000000000000000001
100000000000000000000000001
100000000000000000000000001
100000000000000010000000001
111011100001110101010000001
111000000000000000000000001
100000000000000000000000001
100011111111000000000000001
100010000001000000111100001
100010000000000000000100001
100010000001000N00000100001
100010000001000000000100001
100011111111000000000100001
100000000000000000000100001
111111111111111111111111111

