

NO ./test.xpm

SO ./test.xpm
WE ./test.xpm

EA ./test.xpm


F 222,112,111
C 44,44,55








11111111111111111111111
10000000000000000001111
10000000000000000001111
1000000000000000001111
100000000N0000000001111
10000000000000000001111
10000000000000000001111
10000000000000000001111
10000000000000000001111
11111111111111111111111
11111111111111111111111
