NO ./test.xpm
SO ./test.xpm
WE ./test.xpm

EA ./test.xpm


F 222,112,51
C 44,44,55

            111111     111111
            100001     100001
            100001     100001
            100001     100001
            111111     111111
      11                        11
       11                      11
        11                    11
         11                  11
          11111111111111111111

