

NO ./test.xpm

SO ./test.xpm
WE ./test.xpm

EA ./test.xpm


F 222,112,111
C 44,44,55







111111
100001
10N001
100001
111111

