

NO ./test.xpm

SO ./test.xpm
WE ./test.xpm

EA ./test.xpm


F 222,112,111
C 44,44,55








11111111
1N01  101111
11111111
11111111
11111111
11111111
11111111
11111111
11111111
