

NO ./test.xpm

SO ./test.xpm
WE ./test.xpm

EA ./test.xpm


F 222,112,111
C 44,44,55








111111111111111111111111111111111111111111111111
110000000000011111100000000001111100000000011111
 11111110000000000000000000000000000000111111111
       11111111000000000000000111111111111111111
111111111111111000000111111111111111111111111111
111111111111000000000000000000000000001111111111
111111111111111111111111111111111000001111111111
1111111111111111111111111111111110N0001111111111
111111111111111111111111111111111000001111111111
111111111111111111111111111111111000001111111111
111111110000000000000000000000000000000000000001
111111111111111111111111111111111111111111111111
