

NO ./test.xpm

SO ./test.xpm
WE ./test.xpm

EA ./test.xpm


F 222,112,111
C 44,44,55




111111111111111111111111111
100000000000000000000000001
100000000000000000000000001
111000000001110000000000001
111000000000000000000000001
100000N00000000000000000001
100000000000000000000000001
100000000000000000111100001
100000010000000000000100001
100000000000000000000100001
100000000000000000000100001
100000000000000000000100001
100000000000000000000100001
111111111111111111111111111

